ビカーラ	ウナギの一品種。ニホンウナギに似るがやや小形で、東南アジアに分布。食用としてインドネシアや中国などで養殖される。[補説]平成20年代に入りニホンウナギの不漁と価格高騰が続いたことから、その代用魚として注目された。
ビキューナ	⇒ビクーナ
ビクニア	⇒ビクーナ
ビクーナ	ラクダ科の哺乳類。南アメリカのアンデス山中の高原にすみ、肩高70～110センチ。毛色は赤褐色で下面は白く、羊毛状で長く、毛織物に利用される。ビクーニャ。ビキューナ。ビクニア。
ビクーニャ	⇒ビクーナ
ビションフリーゼ	犬の一品種。カナリア諸島産の犬をフランスで改良したもの。小型の愛玩犬で、毛が長く縮れている。
備前水母	ハチクラゲ綱ビゼンクラゲ科の腔腸 (こうちょう) 動物。傘は半球形で直径50センチにもなり、厚くて硬く、青藍色。口腕は8本ある。瀬戸内海・九州・朝鮮半島に分布。食塩などに漬け、乾燥させたものは中国料理の材料となる。
ビッグホーン	ウシ科ヒツジ属の哺乳類。体高約1メートル。雌雄とも角をもち、雄では巨大で螺旋 (らせん) 状をなす。晩秋から初冬の交尾期に、雄は角をぶつけ合って争う。シベリア・北アメリカの山地に分布。おおつのひつじ。
美之主貝	マルスダレガイ科の二枚貝。東北地方以北からサハリン・千島列島付近にかけて分布。浅海の砂泥地にすむ。殻長約10センチ。殻表は灰白色で厚みがある。食用。名称は、かつての属名Venusに由来。
白狐	１ 白い毛のキツネ。また、年を経て毛が白くなったキツネ。神通力をもつとされた。しろぎつね。２ ホッキョクギツネの別名。
ビルビー	有袋目ミミナガバンディクート科の哺乳類。体長約40センチメートルで尾が長く、耳はウサギに似る。夜行性。オーストラリアに生息するが、近年は絶滅に瀕 (ひん) している。
ビルマ猫	家猫の一品種。体つきはがっしりし、毛は短く濃褐色。ミャンマーの在来種にシャム猫を交配して米国で作り出された。
ビロード金黒	カモ科の鳥。全長58センチくらい。雄は全身黒色で、翼に白帯があり、黄色いくちばしの付け根に隆起がある。雌は茶色で、目の下に淡色部がある。冬に北海道・本州の海でみられる。
枇杷貝	ビワガイ科の巻き貝。浅海の砂泥底にすむ。貝殻の形はビワの実に似て、殻高11センチ。殻表は布目状をし、褐色の電光模様がある。ふたはない。本州中部以南に分布。
琵琶蟹	アサヒガニ科の甲殻類。やや深い海の砂底にすむ。甲は細長い楕円形で、甲長約4.5センチ。表面は滑らかで淡紅色。本州太平洋岸から南に分布。
琵琶鱒	サケ科の淡水魚。全長約50センチ。背側は蒼黒色に小黒斑が散在し、腹側は銀白色。琵琶湖の原産であるが、芦ノ湖や中禅寺湖などにも移殖されている。食用。
便追	セキレイ科の小鳥。全長16センチくらい。体の上面は緑褐色、下面は白色に黒い縦斑がある。アジアに分布。日本では漂鳥で、樹林にすむ。地上で餌をとり、尾を上下に振る。きひばり。《季 夏》「便追の巣鳥がたちぬ樹の根より／秋桜子」
鬢長	⇒びんなが（鬢長）
鬢長	サバ科の海水魚。マグロの一種で、全長約1メートルと小形。胸びれが著しく長い。世界の温帯海に分布。主に缶詰の材料とされる。とんぼしび。びんながまぐろ。びんちょう。《季 冬》
鬢長鮪	⇒鬢長 (びんなが) 
ビーグル	犬の一品種。英国原産のうさぎ狩り用猟犬。体高約35センチ。体つきはがっしりし、耳は垂れ、毛は短くて白・黒・褐色の斑がある。
ビートル	１ 甲虫 (こうちゅう) 。多く、カブトムシのことをいう。２ （Beetle）フォルクスワーゲン社製の小型車の愛称。商標名。
ビーバー	齧歯 (げっし) 目ビーバー科の哺乳類。体長74センチ、尾長30センチくらい。目・耳は小さく、尾は上下に平たくてうろこで覆われ、後ろ足に水かきをもつ。川や湖にすみ、かじった木や石でダムを築いて水をせき止め、できた池の中央に安全なすみかを作る。ヨーロッパ・北アメリカに分布するが、良質の毛皮のために乱獲され、生息数は少ない。海狸 (うみだぬき・かいり) 。
