大王烏賊	ダイオウイカ科の頭足類。最大のイカで胴長約1.6メートル、全長約6メートル。日本近海の深海にすむ。タイセイヨウダイオウイカは全長約16メートルになる。
大王具足虫	等脚目スナホリムシ科の甲殻類。体節が多くダンゴムシに似る。体長30～40センチメートルで等脚類では最大。大西洋などの深海底にすむが、生態は不明な点が多い。
大黒金亀子	コガネムシ科の昆虫。体長約2.5センチ。体は楕円形で厚みがあり、黒色。雄には長い角がある。山地の牧場にみられ、地中に穴を掘り獣糞 (じゅうふん) を集めて産卵する。
大黒鼠	シロネズミの別名。白色が吉兆とされ、福をもたらす大黒天の使いとされた。
大根葉虫	ハムシ科の昆虫。体長4ミリほどで黒褐色。幼虫は大根などアブラナ科の野菜の害虫。本州から沖縄にかけてみられる。
大鷺	サギ科の鳥。全長89センチくらいで全身白色。水辺でみられる。温・熱帯地方に分布。日本では、冬鳥として本州以南に渡来する亜種と、夏鳥または漂鳥として本州以南で繁殖する亜種（チュウダイサギ）とがある。ももじろ。
大杓鷸	シギ科の鳥。シギ類中最大で全長約60センチ。くちばしが非常に長く、下方に曲がっていて、干潟でカニ・シャコなどを食べる。背は黒褐色の縦斑があり、腰は白い。日本では春・秋にみられる。
大膳	１ チドリ科の鳥。全長約30センチ。北極圏のツンドラで繁殖し、熱帯地方で越冬する。日本には春・秋に渡来し、海岸・河口・干潟でみられる。２ 「大膳職 (だいぜんしき) 」の略。
だいみょうせせり	セセリチョウ科のチョウ。翅 (はね) は黒褐色で、前翅に大小の白紋がある。林縁に多くみられ、花に集まる。幼虫の食草はヤマノイモなど。
岳烏	《「たけがらす」とも》ホシガラスの別名。
駝鳥	ダチョウ目ダチョウ科の鳥。現生の鳥類では最大で、雄は頭高約2.5メートル、体重約135キロ。頭は小さく、くびが細長い。足の指は2本。脚が強大で走るのが速いが、翼が小さく飛べない。アフリカのサバンナに分布。
ダックスフント	犬の一品種。ドイツの原産。胴が長く四肢が短い。元来はアナグマ猟の猟犬。
駄津	ダツ目ダツ科の海水魚。全長約1メートル。体は細長く、側扁する。上下両あごが伸びて長いくちばし状となり、鋭い歯がある。背側は緑褐色、腹側は白色。食用。
壁蝨	《古くは「たに」とも》１ ダニ目の節足動物の総称。体は頭・胸・腹の区別がない楕円形で、ふつう歩脚は四対。種類が多く、人畜について血を吸うイエダニ・ツツガムシなどのほか、食料品につくコナダニ・ホコリダニ、農作物を加害するハダニなど有害なものが知られるが、無害な種類のほうがはるかに多い。２ 自分では働かず、ゆすり・たかりで暮らす嫌われ者。「街の壁蝨」[補説]「蟎」は国字。
ダブ	ハト目ハト科の鳥の総称。特に小形の種類をいい、平和の象徴とされる白いハトもこれに含まれる。[補説]大形種はpigeon（ピジョン）という。
だぼ鯊	小さいハゼ類を軽んじた呼び方。チチブ・ドロメ・アゴハゼをさすことが多く、ごり・どんこなどともいう。《季 夏》
達磨鸚哥	インコ科の鳥。全長約35センチで体は緑色。雄のほおに太く黒い線がある。南および東南アジアに広く分布。飼い鳥とされる。
だるまおこぜ	オニオコゼ科の海水魚。全長約15センチ。頭部にこぶが多数ある。日本南部からオーストラリアに分布。
達磨蛙	アカガエル科のカエル。体長5～6センチ。トノサマガエルに似るが後肢は短く、ずんぐりして、背面に黒色円紋がある。日本特産種で、山陽地方に多い。
ダルメシアン	《「ダルマシアン」とも》犬の一品種。クロアチアのダルマチア地方の原産。体形はポインターに似て、白色の地に黒などの丸い斑点がある。
団子魚	１ カサゴ目ダンゴウオ科の海水魚。体長1～3センチ。体は球形に近く、腹びれの変形した吸盤で岩などにつく。晩冬から早春にかけて日本沿岸で産卵する。２ ダンゴウオ科の魚の総称。ダンゴウオ・ホテイウオなど。
団子虫	オカダンゴムシ科の甲殻類。体長14ミリくらい。灰褐色から青灰色。全体がかまぼこ形で、触れると体を丸める。倒木や石の下、落ち葉の中に多い。広くは、海岸の小石の間にいるハマダンゴムシなどを含め、体を丸めることのできる陸生のものを総称する。
だんどく	コシジロキンパラの別名。
ダーウィンフィンチ	スズメ目ホオジロ科に属する小鳥。ガラパゴス諸島およびココ島に14種ほどが分布する。島ごとに著しい変化があり、ゾウガメとともに、ダーウィンが進化論を築くための重要な材料となった。
ダーウィンレア	全長約95センチのダチョウに似た鳥。ペルー南部からアルゼンチン南部のパタゴニアにかけてのアンデス山脈の高地にすむ。数は減少している。
